11111111111111111111
10000000000000000001
10000000000000000001
10000000000000000001
10000000000000000001
10000000000001111111
10000000000000000001
10000001111111000001
10100000000000000001
10100000000000000001
10100000000000000001
11111111111111111111